9 9 9 9 9 9 9 9 9 9 9 9 9 9 9 9 9 1 8 8 8 8 8 1
1 0 0 0 0 0 0 0 0 0 0 0 0 0 0 0 0 8 0 0 0 0 0 8
1 0 9 9 9 9 9 9 9 9 9 9 9 9 0 0 0 8 0 0 0 0 0 8
1 0 1 0 0 0 0 0 0 0 0 0 0 9 0 1 1 1 8 8 8 0 7 1
1 0 1 0 1 0 0 9 9 9 9 9 9 9 0 0 0 0 0 0 0 0 0 7
1 0 1 0 1 0 1 0 0 0 0 0 0 0 0 1 0 1 1 1 1 1 0 7
1 0 1 0 1 0 1 0 0 0 0 0 0 1 0 1 0 1 0 0 0 0 0 7
1 0 1 0 1 0 1 0 0 0 0 0 0 0 0 1 0 1 0 1 1 1 1 1
1 0 1 0 1 0 1 0 0 0 0 0 0 1 0 1 0 1 0 1 0 0 0 6
1 0 1 0 1 0 1 0 0 0 0 0 0 1 0 1 0 1 0 1 0 1 0 6
1 0 1 1 1 0 1 1 0 1 1 1 1 1 0 0 0 1 0 1 0 1 0 6
1 0 1 0 0 0 0 1 0 1 0 0 0 1 0 1 0 0 0 0 0 1 0 6
1 0 1 0 0 0 0 1 0 1 0 0 0 1 1 0 1 1 1 1 1 1 0 6
1 0 1 0 0 0 0 1 0 1 0 0 0 1 1 0 1 0 0 0 0 1 0 6
1 0 1 0 0 0 0 1 0 1 0 0 0 1 1 0 1 0 0 0 0 1 0 6
1 0 1 0 0 0 0 1 0 1 0 0 0 1 1 0 1 1 0 0 1 1 0 6
1 0 1 0 1 1 1 1 0 0 1 0 1 0 0 0 0 0 0 0 0 0 0 6
1 0 1 0 0 0 0 0 1 0 1 0 1 0 1 1 1 0 0 0 0 0 0 6
1 0 1 1 1 1 1 0 1 0 0 0 0 0 1 0 1 0 1 1 1 0 1 1
1 0 1 0 0 0 0 0 0 0 0 1 1 1 1 0 0 0 0 0 0 0 0 5
1 0 3 0 3 3 3 3 3 3 0 1 0 0 0 1 1 1 1 0 0 0 0 5
1 0 3 0 0 0 0 0 0 3 0 1 0 0 0 0 0 0 0 0 0 0 0 5
1 0 3 0 0 0 0 0 0 3 0 1 0 0 0 0 0 0 0 0 0 0 0 5
1 0 3 0 0 0 0 0 0 3 0 1 0 0 0 0 0 0 0 0 0 0 0 5
1 0 3 3 3 0 3 3 3 0 0 0 1 0 0 0 0 0 0 0 0 0 0 5
1 0 0 0 0 0 0 0 0 0 2 0 0 0 0 0 0 0 0 0 0 0 0 5
2 2 2 2 2 2 2 2 2 2 2 4 4 4 4 4 4 4 4 4 4 4 4 1
